##########
#        #
#@#    o #
#        #
#        #
##########