##########
#        #
#@#    o #
#    x   #
#        #
#    x   #
#    x#  #
# oo     #
#        #
##########